1 2 2 2 2 2 2 3 3
1 2 2 3 3 2 2 2 2
1 2 2 2 2 2 2 3 3 4 4
1 2 2 2 2 2 2 3 3
1 2 2 2 2 3 3
1 2 2 3 3 2 2
1 2 2 3 3 2 2
1 2 2 2 2 3 3 2 2 3 3
1 2 2 2 2 2 2
1 2 2 2 2 3 3 3 3
1 2 2 2 2
1 2 2 3 3 3 3 2 2 3 3 4 4
1 2 2 2 2 3 3
1 2 2 2 2 3 3
1 2 2 2 2
1 2 2 2 2
1 2 2 2 2 3 3
1 2 2 2 2 3 3 4 4 5 5
1 2 2 2 2
